+--------------------------------------------------+
|,*****,**,,~~~*****C*,***,******,*,**,~~~~~~~~~,,,|
|,****C*,*,**~~~,,****,****K*,*,******~~~~~~~~~~~,*|
|*****,~*****~~~**,C*,,***KK,**,**,**~~~~~~~~~~~~~,|
|*#*,~~~~~C**~~~~C^^**C****,,CC**^,**~~~~~~~~~~~~~*|
|####~~~~~~~~~~~~^^^^****,,*,***^^^*,~~~~~~~~~~~~~,|
|C#C~~~~~~~~~~~~~~^^^^,,***,,**^^^^^~~~~~~~~~~~~~~~|
|##C#~~~~~~~~~~~~~~^^^^,,,,,,,^^^^^,,~~~~~~~~~~~~~,|
|##C#~~~~~~~~~~~~~~~^^^^,,,,,^^^^^,,,~~~~~~~~~~~~~,|
|#####,~~~~~~~~~~~~~^^C^^,,,^^^^^,,,,~~~~~~~~~~~~~,|
|##C##,~~~~~~~~~~~~~,^C^^^,^^^^K,,,,,,~~~~~~~~~~~##|
|####,~~~~~~~~~~~~~~~,^^C^^K^^^KK,,,,,,~~~~~~~~~K##|
|,C,,,,~~~~~~~~~~~~~,,,^^^^C^^,,,,,,,,,,~~~~~~~~~#K|
|,,,,,,~~~~~~~~~~~~~~~,,^^^^^,,,K,,,,,,,,,,~~~~~,#,|
|,,,#,,~~~~~~~~~~~~~~~~,^^^^^^,,,,,,,K,,K,,~~~~~,,,|
|,,##C,,~~~~~~~~~C~~~~~~^^^^^C^,,,,C^,^C,^,^,~K,,^K|
|,#C###,CC~~~~~~~~~~~~~~~,,^^^,,,,^^^^^C^^^^^^C^^^^|
|,,##C,,,,~~~~~~~~~~~~~~~,,,C,,,,^C^^^^^^^^^^^^^^^^|
|,,,C,,,,C,,~~~~~~~~~~~~~C,,,K,,,,^C^^^^^^^^^KK^KK^|
|,,,,,CC,,,~~~~~~~~~~~~~~~,,,,K,,,KC^#^^#^#^##C##^K|
|,,,,,,,C,,,~C~~~~~~~~~~~~~,,,,,,,,K#KK#K####K#####|
|,,,,,,,,,,~~~~~~~~~~~~~~~,,,,,,,,C####K###K#######|
|,,,,,,,,,,,~~~~~~~~~~~~~~K,,K,,,,,##C#####K#K#####|
|,,,,,,,,,,~~~~~~~~~C~~~~,,,K,$,,,,###K##K###K###K#|
|,,,,,,,,,,,C~~~~~~~~~C,,CC,,,,,,,,###K#####K#KK##,|
|,,,,,,$,C,C~~,~~~~~~~,,,,,,,,,,,,,,#######,,,#,K,,|
|,,,,,,,,C,~~~,,,,~,,,,C,,,,C,,,,,,,,,,#K,,,,K,,,,,|
|,,,,C,,,,,~C~,,,,,C,C$,,,,C,K,,,,,,,C,,,,,,,K,,,,,|
|,,,,,,,C,,~C~,,,,,,,,,,,,,,,,,,C,,,K,,,C,,,,,,,,,,|
|,,,,,,,C,~~~,,C,#K,,,,,,,,,,,,,,,,C,,,,,,K,,,,K,,,|
|,,,CC,,,~~~,,#C#CC#C,,,,,,,,,,,,,,,,,,,KK,,,K,,,K,|
|,,$C,,,,~~~,####CC#C#C,,,C,,,C,,,,,,,,,,,,,,,,,,,,|
|,,,,,,,,~C~,#####C###,,,,,,,,,C,,,,,,,,,,,,,,,,T,,|
|,,,C,,,~~~,,######C##,,,,,,,,,#,,,,,,,,,,K,,,,,,,K|
|C,,,,,,~~~,###########,,,,,,#C#C#C,,,,,,,,,,,,,,,,|
|,,,,,,~~~,,,#########,,,,,C,#####C,,,,,,,C,,,,,,,,|
|,,,,,,,~~~C,#C#######,,,,,,C##C###,,,,,,,,,,,,,,,,|
|,,,,,,~~~~~~~#C#C##C#C,,,,,,C#CC#,,,,.,,,,,,,,,,,,|
|,,,,,~~~~~~~~~CCCC#C,,,,,,,,#####,,.....,,#,,,,,,,|
|,,,,~~~~~~~~~~~.#..,CC,,,C,C,,C,,,....KK####K,,,,,|
|,,..~~~~~~~~~~~...,C,,,,,,,,,,,K,,..K..#####K#,,,,|
|,...~~~~~~~~~~~...,,,,,,,,,,,,,,,......K####K#,,,,|
|,..~~~~~~~~~~~~~.,,,,,,,,,,,,,,,,K....###K##K##,,,|
|..##~~~~~~~~~~~,,,,,,,,,,,,,,,,,,...K..#^K#K##,K,,|
|,#C#~~~~~~~~~~~,,,,,,,,,,,,,,,,,,K.....K^^K###,,#K|
|,###~~~~~~~~~~~,,,,,,,,,,,,,,,,,,...K.^^^^^#K,####|
|,####~~~~~~~~~,,,,,,,,,,,,,,,,,,.......^^^K,,,#K##|
|######~~~~~~~,,,,,,,,,,,,,,,,,,,,.#....^^^,,,#####|
|,######~~~C$,,,,,,,,,,,,,,,,,,,,#####..^^^$,,,#K##|
|.#######~~~,,,,,,,,,,,,,,,,,,,,,#####.^^^^^,,,####|
|,########~~~,,,,,,,,,,,,,,,,,,,#######^^^^^,,,,,#,|
+--------------------------------------------------+