ЛЕГЕНДА: ~ вода  # лес  ^ горы  . пустыня  , равнина  * тундра  $ ресурсы
Существа: G=Grazor  L=Lupax  T=Terrax  S=Skywing  K=Shakrit  M=Mycor  A=Aquor  C=Cryon

+--------------------------------------------------+
|,*****,**,,~~~*******,***,******,*,**,~A~~~~~~~,,,|
|,*G**C*,*,**~~A,,***M,****$*,*,C*****~~~~~~~~~~~,*|
|*T***,~*****~~~*T,*M,,***,,,*C,M*,**~~~~~~~~~~~A~,|
|*M*,~~~C~***~~~~*^^*L*****S,****^,**~A~~~~~~~~~~~*|
|G###~~~~~~A~~~~~^^^^**CC,M*,**M^^^*K~~~~~A~~~~~~~,|
|L##~~~~~~~~~~~~~~^^^^,,***K,**^^^^S~~~~~~~~~~~~~~~|
|####~~~~~~~~~~~A~~^^^^,,,,,,,^^^^^,,~~~~~~~~~~~~~,|
|#G##~~~~~~~~~~~C~~A^M^^,,,,,^^^^T,G,~~~~~~~~~~~~~,|
|#M#MM,~~~~~AC~~~~~~^^^^^,,,T^T^^,,,,~~~A~~~~A~~~~,|
|#####,~~A~~~~~~~~~~,^^^^^,^M^^^,,,,,,~A~~A~~~~~~##|
|###L,~~~~A~~~~~~~~~~,^^^^^^^^^,,,L,G,,~~~~~~~~~###|
|,#,,,L~~~~~~A~~~~~~,,,^^^^C^^S,,,,,,,,,~~A~~~~~~##|
|,,,,,,~~~~~~~~~~~~C~~,,^^^^^,,,C,K,G,,,,,,~~~~~,#,|
|,,,#G,~~~~~~~~~~~~~~~~G^^^^^^,,,M,,,,,,,,,~~~~~,,,|
|,,#G#G,~~~~~A~~~~~~~~A~^^^^^^^,SC,^^,^S,^,^,~^,,^,|
|,K##M#,,~~~~~~~~~~~~~~~~,,^^^,G,,^^^^^^^K^^^^^^^T^|
|,,###,,T,A~~~~~~~~A~~~~~,,S^,,,,^^^^^^K^T^^^^^^^^^|
|,,,#,,,,,,,~~~~~~~~A~~~~~GM,,,,,,C^^^^^^S^^^^^^^^^|
|,,,,,,,G,,~~~~~~~~~~~~~A~,,,,,K,,,^^#^^#^#^##^##^C|
|,,,,,,,,,,K~~~~~~~~~~~~~~~,,,,,,,,#########T#G####|
|,,G,,,,,,,~~~~~~~~~~~~~~~,,,,,,,,L#M#######G######|
|,,,,G,,,,,,~~A~~~~~~~~~~~,SG,M,,,,###M#T#G########|
|S,T,,,G,,,~~~~~~~~~~~~~~,,,G,T,,,,####MC#M########|
|,,,,,,,,,,G~A~~~~~~~~~,,,,,,,,,,,,#M####MG#######,|
|,,,,,GT,,,~~~,~A~~~~~,,,G,,,,,,,,,,##M#M##,,,#,,S,|
|,S,,,M,,,,~~~L,LT~,,,,,,,,,,,,,,,,,,,G#,,,,,,,,,,,|
|,,,,S,,,,,~~~S,,,,,,,T,,S,,G,,G,,,,,,,,,,,,,,,,M,K|
|,,,,,,,,,,~~~,,,,SL,,,,T,,,,,,,,,,,,,GG,,,,G,C,,,,|
|,,,,C,M,,A~~,,,,#S,M,,,,,,,,,,,K,,,,,,,,,,,C,M,,,,|
|,,,,,,,M~~~,,#M#LG##,,,,,,,,,,,,,TS,,,G,,,,,,,,,,,|
|,,T,,K,,~~~,##M#M####,,,M,,,,,KL,,,,,,,,,,G,,,,,,,|
|,,,,,,,,~~~K#######MG,,,,KK,,,,,,S,,,,,,,GG,,LG,K,|
|,,,LG,,~~~,G##G######,,,,,,,,,L,,,,,,,,,,,,,,,,,,,|
|,,,,,,,A~~,#####G#####,,,,,,G####,,,,,,,,T,,,,,,,G|
|,,,,T,~~~TG,GG#M#####,,,,,,,###M#,,G,,,S,L,,GK,L,,|
|,,,,,,,~~~,,#######K#,,,,,,MG###C#,,,,,,,M,,,,,,M,|
|,,,,,,~~~~~~~##G#K###,,GT,,,####C,,,G.,,T,,,,,,,S,|
|,G,L,~~~~~~~~~#M####,,,,,,,,G###M,,.KK..,,#,,,,,,,|
|G,,,~~~~~~~~A~~.#K.,,,G,,,,,,,#,G,....K.M####,,,,,|
|,K..~A~~~~~~~~~...,,,,,,,,,,,,,,,,.....#G#####,,M,|
|,K..~~~~~~~~~~~...,G,,,,,,,,,,C,,.....G######G,,,,|
|,..AAA~~~~~~~~~~.,,,,,,,,G,,,,,,,,....###M###G#,CK|
|K.##~~~~A~~~~~~TK,,,,,,,,GL,,,,,,......#^#C###,,,,|
|,##G~~~~~~~~~~~,,,,,,,,,,,,M,,,,,......MK^##G#,C#,|
|,###~~~~~~~A~~~,,,,,,,,,,K,,,,,,,....K^^^T^##,####|
|,####~~~~~~~~~,,,,,,,,,,,,,,,K,,.......^^^#,,,#K##|
|######~~~~A~~,,,,,,,,,,M,S,,,G,,,.#....^^^,,L##MG#|
|,G#L#M#~~~,$,,MGG,,,,,,,,,,,,,,,#####..K^^MG,,###M|
|.###G#M#~~~,,G,,,S,S,,,G,,,,,,,,G#G##K^^^^^,,,####|
|,########~~A,M,,,G,,,MC,S,,,,,,###G###^^^^^,,,,,#S|
+--------------------------------------------------+